6 2 2 2 2 2 2 2 2 2 2
X 1 2 3 4 5 6 7 8 9 A B C D E F G H I J K L M N O P Q R
1 0 0 0 0 0 0 0 0 0 0 0 0 0 0 0 0 0 0 0 0 0 0 0 0 0 0 0
2 0 0 0 5 4 3 2 1 7 6 5 4 3 2 1 7 6 5 4 3 2 1 7 0 0 0 0
3 0 0 0 6 0 0 0 0 0 0 0 0 0 0 0 0 0 0 0 0 0 0 6 0 0 0 0
4 0 0 0 7 0 0 0 0 0 0 0 0 0 0 0 0 0 0 0 0 0 0 5 0 0 0 0
5 0 0 0 1 0 0 4 3 2 1 7 6 5 4 3 2 1 7 6 5 0 0 4 0 0 0 0
6 0 0 0 2 0 0 5 0 0 0 0 0 0 0 0 0 0 0 0 4 0 0 3 0 0 0 0
7 0 0 0 3 0 0 6 0 0 0 0 0 0 0 0 0 0 0 0 3 0 0 2 0 0 0 0
8 0 0 0 4 0 0 7 0 0 7 6 5 4 3 2 1 7 0 0 2 0 0 1 0 0 0 0
9 0 0 0 5 0 0 1 0 0 1 0 0 0 0 0 0 6 0 0 1 0 0 7 0 0 0 0
A 0 0 0 6 0 0 2 0 0 2 0 0 0 0 0 0 5 0 0 7 0 0 6 0 0 0 0
B 0 0 0 7 0 0 3 0 0 3 0 0 7 6 0 0 4 0 0 6 0 0 5 0 0 0 0 
C 0 0 0 1 0 0 4 0 0 4 0 0 0 5 0 0 3 0 0 5 0 0 4 0 0 0 0
D 0 0 0 2 0 0 5 0 0 5 0 0 0 4 0 0 2 0 0 4 0 0 3 0 0 0 0
E 0 0 0 3 0 0 6 0 0 6 7 1 2 3 0 0 1 0 0 3 0 0 2 0 0 0 0
F 0 0 0 4 0 0 7 0 0 0 0 0 0 0 0 0 7 0 0 2 0 0 1 0 0 0 0
G 0 0 0 5 0 0 1 0 0 0 0 0 0 0 0 0 6 0 0 1 0 0 7 0 0 0 0
H 0 0 0 6 0 0 2 3 4 5 6 7 1 2 3 4 5 0 0 7 0 0 6 0 0 0 0
I 0 0 0 7 0 0 0 0 0 0 0 0 0 0 0 0 0 0 0 6 0 0 5 0 0 0 0
J 0 0 0 1 0 0 0 0 0 0 0 0 0 0 0 0 0 0 0 5 0 0 4 0 0 0 0
K 0 0 0 2 3 4 5 6 7 1 2 3 4 5 6 7 1 2 3 4 0 0 3 0 0 0 0
L 0 0 0 0 0 0 0 0 0 0 0 0 0 0 0 0 0 0 0 0 0 0 2 0 0 0 0
M 0 0 0 0 0 0 0 0 0 0 0 0 0 0 0 0 0 0 0 0 0 0 1 0 0 0 0
N 0 0 0 0 0 0 0 0 0 0 0 0 0 0 0 0 1 2 3 4 5 6 7 0 0 0 0

		       O
--------------------[^^^^^]--------------------